1111111111
1000000001
1200010101
1111010101
1000000101
1011111101
1000000001
1111111101
1100100001
1101001111
1000000001
1111111311